Measurement	Abbreviations
17-hydroxycorticosteroids	17-OHCS
17-ketosteroids	"17-KS, 17KS"
alanine aminotransferase	"ALT, transaminase"
albumin	"AL, ALB"
alkaline phosphatase	"AP, ALP, ALKP, Alk Phos"
amylase	AMS
apolipoprotein B	ApoB
aspartate aminotransferase	AST
bands	"N-bands, PMN, PNM"
basophils	"BASO, BAS"
bicarbonate	HCO3-
bilirubin	Bil
bleeding time	BT
body height	height
body mass index	BMI
body temperature	BT
body weight	weight
brain natriuretic peptide	"BNP, B-Type Natriuretic Peptide"
calcium	"Ca2+, Ca"
cell count	CBC
chloride	Cl-
cholesterol	CHOL
creatine kinase	CK
creatinine	Cr
diastolic blood pressure	DBP
eosinophils	EOS
erythrocyte sedimentation rate	ESR
follicle-stimulating hormone	FSH
glucose	FBS
heart rate	HR
hematocrit	"Hct, Crit, HCT, PCV"
hemoglobin	HGB
hemoglobin A1C	"HbA1c, A1c"
high-sensitivity C-reactive protein	"hs-CRP, hsCRP, cardiac CRP"
IgA	IgA
IgE	IgE
IgG	IgG
IgM	IgM
iron	Fe
lactate dehydrogenase	"LD, LDH"
lipoprotein (a)	"Lpa, Lp(a)"
lutenizing hormone	LH
lymphocytes	"Lymph, Lymphs"
magnesium	"Mg2+, Mg"
mean blood pressure	"BP, MBP"
mean corpuscular hemoglobin	MCH
mean corpuscular hemoglobin concentration	MCHC
mean corpuscular volume	MCV
monocytes	"Mono, Monos"
myoglobin	MB
N-terminal pro b-type natriuretic peptide	NT-proBNP
osmolarity	Osmo
oxalate	Oxal
parathyroid hormone	PTH
partial thromboplastin time	PTT
PCO2	PCO2
pH	pH
phosphorus	PO4
platelet count	"PLT, PLT Ct"
PO2	PO2
potassium	K+
prolactin	"hPRL, PRL"
prothrombin time	PT
red cell volume	MCV
respiratory rate	"RR, Resp"
reticulocyte count	Retic
segmented neutrophils	N-Seg
sodium	"Na+, Na, NA"
systolic blood pressure	SBP
thrombin time	TT
thyroid-stimulating hormone	TSH
thyroidal iodine uptake	123I
thyroxine	T4
triglycerides	"Trig, TG, TAG"
triiodothyronine	T3
troponin I	"TnI, cTnI"
urea nitrogen	BUN
uric acid	Urate
zinc protoporphyrin	"ZP, ZPP, FEP"
prostate specific antigen	PSA
ethanolamine	EA
erythropoietin	EPO
d-dimer	FDP
aortic root diameter	AoR
mid-descending aorta diameter	AoD
LDL cholesterol	LDL
HDL cholesterol	HDL
blood urea nitrogen	BUN
left ventricular ejection fraction	"LVEF, EF"
homocitrulline	Hcit
troponin T	"TnT, cTnT"
zinc	Zn
vitamin k	"VK, VITK"
alpha-fetoprotein	AFP
fibronectin	FN
voltage-gated neuronal potassium channel antibodies	VGKC
neuronal ganglionic acetylcholine binding antibodies	AChR
occult blood	FOBT
heart ceramides	"ceramide, ceramides, ceram, cer"
calcitonin	CT
fibrinogen	"FIB, factor I"
haptoglobin	HP
rheumatoid factor	"RA factor, RF"
corrected QT interval	QTc
